################
#______#_______#
#______#__#____#
#____###_______#
#____________###
#____###_______#
#______###_____#
#________#_____#
#________#_____#
#______________#
#______________#
#______________#
#______________#
#______________#
#______________#
################
