################
#0_____#_______#
#0_____#__#____#
#0___###_______#
#0___0000000_###
#0___###___0___#
#0_____###_0___#
#0______0#_0___#
#0______0#_0___#
#0______0__0___#
#0______0__0___#
#0______0__0___#
#0______0__0___#
#0______0__0___#
#00000000000___#
################
